1111111
1P000E1
1000001
100C001
1000001
1P000E1
1111111
