111111111111111111111111111111111111111111111111111111111111
1P0000000000000000000000000000000000000000000000000000000001
100000000000000000000000000000000000000000000000000000000001
100000111111111111111111111111111111111111110000000000000001
1000001000001C00000000000000000000000C1000010000000000000001
100000100000100000000000000000000000001000010000000000000001
100000100000100000000000000000000000001000010000000000000001
100000111111100000000000000000000000001111110000000000000001
100000000000000000000000000000000000000000000000000000000001
100000000000000000000000000000000000000000000000000000000001
100000000000000000000000000000000000000000000000000000000001
100000111111111111111111111111111111111111110000000000000001
100000100000100000000000000000000000001000010000000000000001
100000100000100000000000000000000000001000010000000000000001
100000100000100000000000000000000000001000010000000000000001
100000111111100000000000000000000000001111110000000000000001
100000000000000000000000000000000000000000000000000000000001
100000000000000000000000000000000000000000000000000000000001
100000000000000000000000000000000000000000000000000000000001
100000111111100000000000000000000000001111110000000000000001
100000100000100000000000000000000000001000010000000000000001
100000100000100000000000000000000000001000010000000000000001
100000100000100000000000000000000000001000010000000000000001
100000111111111111111111111111111111111111110000000000000001
100000000000000000000000000000000000000000000000000000000001
100000000000000000000000000000000000000000000000000000000001
100000000000000000000000000000000000000000000000000000000001
100000111111111111111111111111111111111111110000000000000001
100000100000100000000000000000000000001000010000000000000001
100000100000100000000000000000000000001000010000000000000001
1000001000001000000000000000000000000010000100000000000000E1
111111111111111111111111111111111111111111111111111111111111
